10 x 10 : 300
0, 0, 0, 0, 0, 0, 0, 0, 0, 0 
0, 5, 5, 5, 5, 5, 5, 5, 5, 0 
0, 5, 5, 5, 5, 5, 5, 5, 5, 0 
0, 5, 5, 0, 0, 0, 0, 5, 5, 0 
0, 5, 5, 0, 9, 9, 0, 5, 5, 0 
0, 5, 5, 0, 9, 9, 0, 5, 5, 0 
0, 5, 5, 0, 0, 0, 0, 5, 5, 0 
0, 5, 5, 5, 5, 5, 5, 5, 5, 0 
0, 5, 5, 5, 5, 5, 5, 5, 5, 0 
0, 0, 0, 0, 0, 0, 0, 0, 0, 0 
