x: 20
y: 14
 0: 0: 0: 0: 0: 0: 0: 0: 0: 0: 0: 0: 0: 0: 0: 0: 0: 0: 0: 0
 0: 0: 0: 0: 0: 0: 0: 0: 0: 0: 0: 0: 0: 0: 0: 0: 0: 0: 0: 0
 0: 0: 5: 5: 0: 0: 5: 5: 0: 0: 0: 0: 5: 5: 5: 5: 5: 5: 0: 0
 0: 0: 5: 5: 0: 0: 5: 5: 0: 0: 0: 0: 5: 5: 5: 5: 5: 5: 0: 0
 0: 0: 5: 5: 0: 0: 5: 5: 0: 0: 0: 0: 0: 0: 0: 0: 5: 5: 0: 0
 0: 0: 5: 5: 0: 0: 5: 5: 0: 0: 0: 0: 0: 0: 0: 0: 5: 5: 0: 0
 0: 0: 5: 5: 5: 5: 5: 5: 0: 0: 0: 0: 5: 5: 5: 5: 5: 5: 0: 0
 0: 0: 5: 5: 5: 5: 5: 5: 0: 0: 0: 0: 5: 5: 5: 5: 5: 5: 0: 0
 0: 0: 0: 0: 0: 0: 5: 5: 0: 0: 0: 0: 5: 5: 0: 0: 0: 0: 0: 0
 0: 0: 0: 0: 0: 0: 5: 5: 0: 0: 0: 0: 5: 5: 0: 0: 0: 0: 0: 0
 0: 0: 0: 0: 0: 0: 5: 5: 0: 0: 0: 0: 5: 5: 5: 5: 5: 5: 0: 0
 0: 0: 0: 0: 0: 0: 5: 5: 0: 0: 0: 0: 5: 5: 5: 5: 5: 5: 0: 0
 0: 0: 0: 0: 0: 0: 0: 0: 0: 0: 0: 0: 0: 0: 0: 0: 0: 0: 0: 0
 0: 0: 0: 0: 0: 0: 0: 0: 0: 0: 0: 0: 0: 0: 0: 0: 0: 0: 0: 0
 0: 0: 0: 0: 0: 0: 0: 0: 0: 0: 0: 0: 0: 0: 0: 0: 0: 0: 0: 0
 0: 0: 0: 0: 0: 0: 0: 0: 0: 0: 0: 0: 0: 0: 0: 0: 0: 0: 0: 0
 0: 0: 0: 0: 0: 0: 0: 0: 0: 0: 0: 0: 0: 0: 0: 0: 0: 0: 0: 0
 0: 0: 0: 0: 0: 0: 0: 0: 0: 0: 0: 0: 0: 0: 0: 0: 0: 0: 0: 0
 0: 0: 0: 0: 0: 0: 0: 0: 0: 0: 0: 0: 0: 0: 0: 0: 0: 0: 0: 0
 0: 0: 0: 0: 0: 0: 0: 0: 0: 0: 0: 0: 0: 0: 0: 0: 0: 0: 0: 0
 0: 0: 0: 0: 0: 0: 0: 0: 0: 0: 0: 0: 0: 0: 0: 0: 0: 0: 0: 0
 0: 0: 0: 0: 0: 0: 0: 0: 0: 0: 0: 0: 0: 0: 0: 0: 0: 0: 0: 0
 0: 0: 0: 0: 0: 0: 0: 0: 0: 0: 0: 0: 0: 0: 0: 0: 0: 0: 0: 0
 0: 0: 0: 0: 0: 0: 0: 0: 0: 0: 0: 0: 0: 0: 0: 0: 0: 0: 0: 0
 0: 0: 0: 0: 0: 0: 0: 0: 0: 0: 0: 0: 0: 0: 0: 0: 0: 0: 0: 0
 0: 0: 0: 0: 0: 0: 0: 0: 0: 0: 0: 0: 0: 0: 0: 0: 0: 0: 0: 0
 0: 0: 0: 0: 0: 0: 0: 0: 0: 0: 0: 0: 0: 0: 0: 0: 0: 0: 0: 0
 0: 0: 0: 0: 0: 0: 0: 0: 0: 0: 0: 0: 0: 0: 0: 0: 0: 0: 0: 0
 0: 0: 0: 0: 0: 0: 0: 0: 0: 0: 0: 0: 0: 0: 0: 0: 0: 0: 0: 0
 0: 0: 0: 0: 0: 0: 0: 0: 0: 0: 0: 0: 0: 0: 0: 0: 0: 0: 0: 0
